Maps/map-render.jpg
4
3
1
2
4

000 000 000 000 144 123 000 000 000 000
000 000 000 000 144 123 000 000 000 000
000 000 000 000 144 123 000 000 000 000
000 000 000 000 244 123 000 000 000 000
131 131 131 131 341 313 231 131 131 131
112 112 112 212 324 332 112 112 112 112
000 000 000 000 144 223 000 000 000 000
000 000 000 000 144 123 000 000 000 000
000 000 000 000 144 123 000 000 000 000
000 000 000 000 144 123 000 000 000 000
